1_1_1_1_1_1_1_1_1_1_1_1_1_1_1_1_1_1_1_1_1_
1_3_0_0_0_2_0_0_0_0_0_0_0_2_0_0_0_0_0_0_1_
1_0_1_0_1_0_1_0_1_0_1_0_1_0_1_0_1_0_1_2_1_
1_0_0_0_0_0_0_2_0_0_0_0_0_0_0_0_0_0_0_0_1_
1_0_1_0_1_0_1_0_1_0_1_0_1_0_1_0_1_0_1_0_1_
1_0_2_0_0_0_0_0_0_0_0_2_0_0_0_0_0_0_0_0_1_
1_0_1_0_1_0_1_0_1_0_1_0_1_0_1_0_1_0_1_0_1_
1_0_0_2_0_0_0_0_0_0_0_0_2_0_0_0_0_2_0_0_1_
1_0_1_0_1_0_1_0_1_0_1_0_1_0_1_0_1_2_1_0_1_
1_0_0_0_0_0_0_0_0_0_0_0_2_0_0_0_0_0_0_0_1_
1_0_1_0_1_0_1_0_1_0_1_0_1_0_1_0_1_0_1_0_1_
1_0_0_0_0_0_0_0_0_0_2_0_0_0_0_0_0_0_0_0_1_
1_0_1_0_1_0_1_0_1_0_1_0_1_0_1_0_1_0_1_0_1_
1_0_0_2_0_0_2_0_0_0_0_0_0_0_0_0_0_2_0_0_1_
1_0_1_0_1_0_1_0_1_0_1_0_1_0_1_0_1_0_1_0_1_
1_0_0_2_0_0_0_0_2_0_0_0_0_0_0_0_2_0_0_0_9_
1_1_1_1_1_1_1_1_1_1_1_1_1_1_1_1_1_1_1_1_1_