1_1_1_1_1_1_1_1_1_1_1_1_1_1_1_1_1_1_1_1_1_
1_0_0_0_0_0_0_0_0_0_0_0_2_0_0_0_0_0_0_0_1_
1_0_1_0_1_0_1_0_1_0_1_0_1_0_1_0_1_0_1_0_1_
1_0_0_0_0_0_0_0_0_0_0_0_0_0_2_0_0_0_0_0_1_
1_9_1_0_1_0_1_0_1_0_1_0_1_2_1_0_1_0_1_0_1_
1_0_0_0_0_0_0_0_0_0_0_0_0_0_2_0_0_0_0_0_1_
1_0_1_0_1_0_1_0_1_0_1_0_1_0_1_0_1_0_1_2_1_
1_0_0_0_0_0_0_0_0_0_0_0_0_0_0_0_0_0_0_0_1_
1_0_1_0_1_0_1_0_1_0_1_0_1_0_1_0_1_0_1_0_1_
1_0_0_0_0_0_0_0_0_0_0_3_0_0_0_0_0_0_0_0_1_
1_0_1_0_1_0_1_0_1_0_1_0_1_0_1_0_1_0_1_0_1_
1_0_0_0_0_0_0_0_0_0_0_0_0_0_4_0_0_0_0_4_1_
1_0_1_0_1_0_1_0_1_0_1_0_1_0_1_0_1_2_1_0_1_
1_0_0_0_0_0_0_0_0_0_0_0_0_0_0_0_0_0_0_0_1_
1_0_1_0_1_0_1_0_1_0_1_0_1_0_1_0_1_0_1_0_1_
1_0_0_0_0_0_0_0_0_0_0_0_0_0_0_0_0_0_0_0_1_
1_1_1_1_1_1_1_1_1_1_1_1_1_1_1_1_1_1_1_1_1_
-_+_2_2_0_0_1_1_
9_9_2_2_2_2_-_
1_1_0_0_0_0_-_
1_1_0_0_0_0_-_
19_15_0_0_0_0_-_
19_15_0_0_0_0_-_
19_15_0_0_0_0_-_
