1_1_1_1_1_1_1_1_1_1_1_1_1_1_1_1_1_1_1_1_1_
1_0_0_0_0_2_0_0_0_0_0_0_0_0_0_2_0_0_0_0_1_
1_0_1_0_1_0_1_0_1_0_1_0_1_0_1_0_1_0_1_0_1_
1_0_0_0_2_0_0_0_0_0_0_0_0_0_0_0_0_0_0_0_1_
1_0_1_0_1_0_1_0_1_0_1_0_1_0_1_0_1_0_1_0_1_
1_0_0_0_0_0_0_0_0_0_0_0_0_0_0_0_0_0_0_0_1_
1_0_1_0_1_0_1_0_1_0_1_0_1_0_1_0_1_0_1_0_1_
1_0_2_0_0_0_0_0_0_0_0_0_0_0_0_0_0_0_0_0_1_
1_0_1_0_1_0_1_0_1_0_1_0_1_0_1_0_1_0_1_0_1_
1_0_2_0_0_0_0_0_0_0_0_0_0_2_0_0_0_0_0_0_1_
1_0_1_0_1_0_1_0_1_0_1_0_1_0_1_0_1_0_1_0_1_
1_0_0_0_0_0_0_0_0_0_0_0_0_0_0_0_0_0_0_0_1_
1_0_1_0_1_0_1_0_1_0_1_0_1_0_1_0_1_0_1_0_1_
1_0_0_0_3_0_0_0_0_0_0_0_0_0_2_0_0_0_0_0_1_
1_0_1_0_1_0_1_2_1_0_1_0_1_0_1_0_1_0_1_0_1_
1_2_0_0_0_0_0_0_0_0_0_0_0_0_0_2_4_0_0_0_1_
1_1_1_1_1_1_1_1_1_1_1_1_1_1_1_1_1_1_1_1_1_
-_+_0_1_0_0_1_1_
1_14_1_1_0_0_+_
1_1_0_0_0_0_-_
1_1_0_0_0_0_-_
19_15_0_0_0_0_-_
19_15_0_0_0_0_-_
19_15_0_0_0_0_-_
