1_1_1_1_1_1_1_1_1_1_1_1_1_1_1_1_1_1_1_1_1_
1_3_0_0_0_0_0_0_0_0_2_0_0_0_0_0_0_0_0_0_1_
1_0_1_0_1_0_1_0_1_0_1_0_1_0_1_0_1_0_1_0_1_
1_0_0_0_0_0_0_0_0_0_0_2_0_0_0_0_0_0_0_0_1_
1_0_1_0_1_0_1_0_1_2_1_0_1_0_1_0_1_0_1_0_1_
1_0_0_0_0_0_0_0_0_2_0_0_0_0_0_0_0_0_0_0_1_
1_0_1_0_1_0_1_0_1_0_1_0_1_0_1_0_1_0_1_0_1_
1_0_0_0_0_0_0_0_0_0_0_0_0_0_0_0_0_0_0_0_1_
1_0_1_0_1_0_1_2_1_0_1_0_1_0_1_0_1_0_1_0_1_
1_0_0_0_0_0_0_0_0_0_0_0_0_0_0_0_0_0_0_0_1_
1_0_1_0_1_0_1_0_1_0_1_0_1_0_1_0_1_0_1_0_1_
1_0_0_0_0_0_2_0_0_0_0_0_0_0_0_0_0_0_0_0_1_
1_0_1_0_1_2_1_0_1_0_1_0_1_0_1_0_1_0_1_0_1_
1_2_0_0_0_0_0_0_2_0_0_0_0_0_0_0_0_0_0_0_1_
1_0_1_0_1_0_1_0_1_0_1_0_1_0_1_0_1_0_1_0_1_
1_0_0_0_0_0_0_0_2_0_0_0_0_0_0_0_0_4_0_0_1_
1_1_1_1_1_1_1_1_1_1_1_1_1_1_1_1_1_1_1_1_1_
-_+_1_1_0_0_1_1_
1_1_0_0_0_0_-_
1_1_0_0_0_0_-_
1_1_0_0_0_0_-_
19_15_0_0_0_0_-_
19_15_0_0_0_0_-_
19_15_0_0_0_0_-_
